R 1024 1080

NO ./textures/eagle.xpm
SO ./textures/greystone.xpm
WE ./textures/bluestone.xpm
EA ./textures/wood.xpm
S ./textures/pillar.xpm
C 255, 199, 33
F 144,106,33

111111111111111111111 1
10000020000200000001
1000000000000000001
100020000020001111
100000000000001
100000220000010
100000N000011
1111111111111
